V111|
A Great Feat of Improvisation
BAD - Base Ammunition Depot
BAFF - British Air Forces France
BCV - Bulk Contamination Vehicle
BEF - British Expeditionary Force
BOD - Base Ordnance Depot
BOH - British Official History
BOW - Base Ordnance Workshop
BPFC - Base Petrol Filling Centre
BSA - Base Sub-Area
BSD - Base Supply Depot
CAD - Central Ammunition Depot
CAP - Corps Ammunition Park
C3 - Command, Control & Communications
CCS - Casualty Clearing Station
CIGS - Chief of the Imperial General Staff
C-in-C - Commander-in-Chief
CPP - Corps Petrol Park
CRAOC - Commander Royal Army Ordnance Corps
CRASC - Commander Royal Army Service Corps
CRE - Commander Royal Engineers
CW - Chemical Warfare
CWGC - Commonwealth War Graves Commission
DAA & QMG - Deputy Assistant Adjutant & Quartermaster-General
DAC - Divisional Ammunition Company
DAER - Daily Ammunition Expenditure Rate
DAQMG - Deputy Assistant Quartermaster-General
DDMO - Deputy Director Military Operations
DDOS - Deputy Director Ordnance Services
DDST - Deputy Director Supplies & Transport
DID - Detail Issue Depot
DMI - Director Military Intelligence
DMO - Director Military Operations
DMT - Director Military Training
DOS - Days of Supply or Director Ordnance Services
DPC - Divisional Petrol Company
DQUAD - Destination, Demand, Distance and Duration
DSC - Divisional Supply Column
ECM - En-Cas Mobile
FSPB - Field Service Pocket Book.
FSR - Field Service Regulations
GBAD - Ground Based Air Defence
GHQ - General Headquarters
GLOC - Ground Line of Communication
GOC - General Officer Commanding
GRT - Gross Registered Tonnage
List of Abbreviations
GS - General Staff (or General Service)
GSO - General Staff Officer
GSU - GHQ Salvage Unit
GW - Gas Warfare
GWR - Great Western Railway
HE - High Explosive
HMF - His Majesty's Factory
HMG - Heavy Machine Gun
HMS - His Majesty's Ship
HQ - Headquarters
HRS - Heavy Repair Shop
IGS - Indian General Staff
IPE - Individual Protective Equipment
IWM - Imperial War Museum
KIA - Killed in Action
LMG - Light Machine Gun
LMR - Longmoor Military Railway
LMS - London Midland & Scottish (Railway)
LNER - London & North Eastern Railway
LOC - Line of Communication
MBA - Main Base Area
MBU - Mobile Bath Unit
MEDLOC - Mediterranean Line of Communication
MHE - Material Handling Equipment
MMG - Medium Machine Gun
MOD - Ministry of Defence
MPP - Maintenance Project Plan
MRW - Mobile Railway Workshop
MSBA - Medical Sub-Base Area
MSR - Main Supply Route
MT - Mechanical (or Motor) Transport
MTSD - Motor Transport Stores Depot
MV - Motor Vessel
NAAFI - Navy Army & Air Force Institutes
NBI - Non-Battle Injury
NCP -
- Northern Channel Ports
NGR - Narrow Gauge Railway
nm - nautical mile
OC - Officer Commanding
OIC - Officer-in-Charge
OR - Other Rank(s)
ORB - Operations Record Book (RAF)
ORBAT - Order of Battle
PAD - Passive Air Defence
POL - Petroleum Oils & Lubricants
